f f f f f f f f f f f f f f f f f f f f f f f f f f f f f f f f f f f f f f f f f f
f g g g g g g g f g g g g g g g g g g g g g g g g g g f g f g g g g g g g g g g g f
f g f f f f f g f f f f f f g f f f f g f f f f f f g f g f g f f f f f f g f f g f
f g f g g g g g f g g g g f g f g g f g f g g g g g g f g g g g g f g g g g g f g f
f g f g f f f f f g g g g f g f g f f g f f f f f f g f g f f f f f g g g g g f g f
f g f g f g g g g g g g g f g f g f g g g g g g g g g g g g g g g f g g g g g f g f
f g f g g g f g f f f f f f g f g f f f f f f f f f f g f f f f f f g g g g g f g f
f g f f f g f g g g g g g g g f g f g g f g g g g g g g g g g g g f f f f f f f g f
f g g g f g f g f f f f f f f f g f g g f g f g f f f f f f f g g f g g g g g g g f
f g f g f g f g f g g g g g g f g g g g f g f g g g g g g g f g g f g f f f f f f f
f g f g f g f g f g g g g g g f g f g g f g f g f f f f f g f g g f g f g g g g g f
f g f g f g f g f g f f f f f f g f g f f g f g f g g g g g f g g f g f g f f f g f
f g f g g g f g g g g g g g g f g f g g g g f g f g f f f g g g g g g f g g g f g f
f g f f f f f g f g f f f f g f g f f f f f f g f g g g g g f g g g g f g f f f g f
f g g g g g g g f g g g g f g g g g f g g g g g f g f f f g f g g f g g g g g f g f
f f f f f f f g f g g g g f g f f f f g g g f g f g g g g g f g g f g f g f f f g f
f g f g g g g g f g g g g f g g g g f g f g f g g g g g g g g g g f g f g g g f g f
f g f f f f f f f g g g g f g f g g f g f g f g f g g f f f f f f f f f f f f f g f
f g f g g g g g f f f g f f g f g g g g f g g g f g g g g g g g g f g g g g g g g f
f g f g f g g g g g g g g g g f g g g g f f f f f f f g f f f f g f g f f f f f f f
f g g g f f f f f g f f f f f f f f f g f g g g g g g g g g g g g f g g g g g g g f
f g f g f g g g f g g g g g f g g g g g f g f f f f f f f f f f g f f f f f f f g f
f g f g f g f g f f f f f g f g g f g g f g g g g g g g g g g g g f g g g g g g g f
f g f g f g f g f g g g g g f g g f g g f f f f f f g f f f f f f f g f f f f f f f
f g f g f g f g f g f f f f f g g g g g f g g g g g g g g g g g g f g f g g g g g f
f g f g f g f f f g g g g g f g f f f f f g f f f g f f f f f f g f g f g f f f g f
f g g g f g g g g g f f f f f g g g g g f g g f g g g g g g g g g f g f g f g f g f
f g f f f f f f f g g g g g f g g g g g f g g f g g g f g g g f g f g f g f g f g f
f g g g g g g g f g f f f g f g g g g g f g f f f f f f f g f f f f g f g g g f g f
f g f g g g g g f g g g f g g g g g g g f g g g g g g g g g g f g g g f f f f f g f
f f f f f f f g f g g g f g f g g g g g f g f f f f f g f f f f g g g g g g g g g f
f g f g g g g g f g g g f g f f f g f f f g f g g g g g g g g f g f f f f f g f f f
f g f g g g g g f g f f f g f g g g g g g g f g f f f f f f f f g f g g g g g f g f
f g f g g g g g g g g g g g f g g f g g g g f g g f g g g g g g g f g g f g g f g f
f g f f f f f f f f f f g f f g f f f f g f f f g f g f f f f f f f g g f g g f g f
f g g g g g g g g g g g g g g g g f g g g g g f g f g f g g g g g g g g f g g f g f
f f f f f f f f f g f f f f f f g f g g g g g f g f g f g g f g g g g g g g g f g f
f g g g g g g g f g f g g f g f g f g g g g g f g f g f g g f f f f f g f f f f g f
f g f g g g g g f g f g g f g f g g g g g g g g g g g f g g f g g g g g g g g g g f
f g f f f f f f f g f g g f g f f f f f f f f f f f g f g f f f f f f f f f f f g f
f g g g g g g g g g g g g g g g g g g g g g g g g g g g g g g g g g f g g g g g g f
f f f f f f f f f f f f f f f f f f f f f f f f f f f f f f f f f f f f f f f f f f