1 2 28 28

13 3 1
14 26 0

DDDDDDDDDDDDDDDDDDDDDDDDDDDD
DLLLDDDDDDDDDDDDDDDDDLLLDDDD
DLLLDDDDDDDDLLLDDDDDDLLLDDDD
DDLDDDDLLLLLLLLDDDDDDLLLDDDD
DDLDDDDLDDDDLLLDDDDDDDLDDDDD
DDLLLLLLDDDDDDDDDDDDDDLDDDDD
DDLDDDDDDDDDDDDDDDDDDDLDDDDD
DDLDDDDDDDDDDDDDDDDLLLLLLLDD
DDLDDDDDDDDLLLLLDDDLLLLLLLDD
DDLLLLLLDDDLLLLLDDDLLLLLLLDD
DDDLDDDLDDDLLLLLDDDLLLLLLLDD
DDDLDDDLDDDDDLDDDDDDDDLDDDDD
DDLLLDDLDDDDDLDDDDDDDDLDDDDD
DDLLLDDLDDDDDLDDDDDDLLLLLDDD
DDLLLDDLDDDDDLDDDDDDLDDDLDDD
DDDDDDDLLLLLLLLLLLLLLDDDLDDD
DDDDDDDLDDDDDDDDDDDDLDDDLDDD
DDDDDDDLDDDDDDDDDDDDLDDDLDDD
DDLLLDDLDDLLLDDDDDLLLLDDLDDD
DDLLLLLLLLLLLDDDDDLLLLDDLDDD
DDLLLDDLDDLLLDDDDDLLLLDDLDDD
DDDDDDDLDDDDDDDDDDDDDDDDLDDD
DDDDDDDLDDDDDDLLLLLLLLLLLDDD
DDDDDDLLLLDDDDLDDDDDDDDDDDDD
DDDDDDLLLLDDDDLDDDDDDDDDDDDD
DDDDDDLLLLDDLLLLLDDDDDDDDDDD
DDDDDDDDDDDDLLLLLDDDDDDDDDDD
DDDDDDDDDDDDDDDDDDDDDDDDDDDD


