2 2 28 28

13 25 2
39 17 0

DDDDDDDDDDDDDDDDDDDDDDDDDDDD
DDLLLLLDDDDDLLLDDDDDDDDDDDDD
DDLLLLLLLLDDLLLDDDLLLLDDDDDD
DDLLLLLDDLDDLLLDDDDDDLDDDDDD
DDDDLDDDDLDDDLDDDDDDDLDLLLLD
DDDDLDDDDLLLLLLLLLLDDLLLLLLD
DDDDLDDDDDDDDLDDDDLDDDDLLLLD
DDLLLLLDDDDDDDDDDDLDDDDLLLLD
DDLLLLLLLLLLLLLLLLLDDDDDDLDD
DDLLLLLDDDDDDDDDDDDDDDDDDLDD
DDDDLDDDDDDDDDLLLLLLLLDDDLDD
DDDDLDDDDDDDDDLLLLLLLLDDDLDD
DDDDLDDLLLLLDDLLLLLLLLDDDLDD
DDLLLLLLLLLLLLLDDDLDDDDDDLDD
DDDDDDDLLLLLDDDDDDLDDDDDDLDD
DDDDLDDDDLDDDDDDLLLLLDDDDLDD
DDDDLDDDDLDDDDDDLLLLLLLLLLDD
DDDDLDDDDLLLLLDDLLLLLDDDDLDD
DDLLLLDDDLDDDLDDDDLDDDDDDLDD
DDLDDLDDDLDDDLDDDDLDDDDDDLDD
DDLDDLDDLLLLLLLLLLLLLLLLLLDD
DDLDDDDDDDDDDDDDDDLDDDDLDDDD
DDLLLLLLDDLLLLLLLLLLLLDLDDDD
DDLDDLLLDDLDDLDDDDLDDDDLDDDD
DDLDDLLLDDLDDLDDDDLDDLLLLLDD
DDLDDLLLLLLDLLLDDDLLLLLLLLDD
DDDDDDDDDDDDLLLDDDDDDDDDDDDD
DDDDDDDDDDDDDDDDDDDDDDDDDDDD
