3 2 28 28

15 19 3
14 25 0

DDDDDDDDDDDDDDDDDDDDDDDDDDDD
DDDDDDDDDDDDDDDDDDDDDDDDDDDD
DDDDDDDDDDDDDDDDDDDDDDDDDDDD
DDDLLLLLLLLLLLLLLLLLLLLLLDDD
DDDLDDDDDDDDDDDLDDDDDDDDLDDD
DDDLDDDDDDDDDDDLDDDDDDDDLDDD
DDDLDDLLLDLLLDLLLDLLLDDDLDDD
DDDLDDLLLLLLLDLLLDLLLDDDLDDD
DDDLDDLLLDLLLDLLLDLLLDDDLDDD
DDDLDDDDDDDLDDDLDDDLDDDDLDDD
DDDLDDLLLDDLDDDLDDDLDLLDLDDD
DDDLLLLLLLLLLLLLLLLLLLLDLDDD
DDDLDDLLLDDLDDDDDDDLDLLDLDDD
DDDLDDDLDDDLDDDDDDDLDDDDLDDD
DDDLDDLLLDLLLDLLLDLLLDDDLDDD
DDDLDDLLLDLLLLLLLDLLLDDDLDDD
DDDLDDLLLDLLLDLLLDLLLDDDLDDD
DDDLDDDLDDDDDDDLDDDDDDDDLDDD
DDDLDDLLLDDDDLLLLLDDLLLDLDDD
DDDLDDLLLDDDDLLLLLDDLLLDLDDD
DDDLDDDDDDDDDDDDDDDDDLDDLDDD
DDDLLLLLLLLLLLLLLLLLLLLLLDDD
DDDDDDLDDDDDDDLDDDDDDLDDDDDD
DDDDDDLDDDDDDDLDDDDDDLDDDDDD
DDDDLLLLLDDDLLLLLDDLLLLLDDDD
DDDDLLLLLDDDLLLLLDDLLLLLDDDD
DDDDLLLLLDDDLLLLLDDLLLLLDDDD
DDDDDDDDDDDDDDDDDDDDDDDDDDDD
